12
15
XXXXXXXXXXXXXXX
S XX     XX   F
X XX XXX XX XXX
X XX XX  XX  XX
X    XX XXXX XX
XX X TX   XX XX
XX XXXXXX     X
XX    XXXXXXXXX
X  XX      X  X
X XXXXXXXXXXX F
X  X          X
XXXXXXXXXXXXXXX