20
35
XXXXXXXXXXXXXXXXXXXXXXXXXXXXXXXXXXX
S                XXXXXXXXXX       F
X XXXXXXXX XXXXXXXXXXXXXXXX XXXXXXX
X XX                 T   XX XXXXXXX
X XX XXXXXXXXXXXXXXXXXXX  X XXXXXXX
X    XXXXXXX       XXXXXX X    XXXX
X XXXXXXXXXX XXXXX XXXXXXXXXXX XXXX
X            XXXXX X   XXX     XXXX
X XXXXXX XXXXXXXXX   X  XX XXXXXXXX
X XXXXXX    XXXXXXXXXXX XX XXXXXXXX
X XXXXXXXXX XXXXXXXXXXX XX XX     F
X    T         X    XXX  X XX XXXXX
X XXXXXXXXXXXXXXXXX XXX XX XX XXXXX
X         XXXXXXXXX XXX XX XX XXXXX
X XXX XXX XXXX          XX XXXXXXXX
X XXX XXX    X XXXXXXXXXXX XX XXXXX
X XXX XXX XXXX      XXXXXX XXTXXXXX
X XXXXXXX XXXXXXXXX XXXXXX XX XXXXX
X     T        XXXX           XXXXX
XXXXXXXXXXXXXXXXXXXXXXXXXXXXXXXXXXX