23
70
XXXXXXXXXXXXXXXXXXXXXXXXXXXXXXXXXXXXXXXXXXXXXXXXXXXXXXXXXXXXXXXXXXXXXX
S      XXX   XX   XXXXXXXXXXXXXXXXXXXXXXXXXXXXXXXXXXXXXXXXXXXX       F
XXX XX     X    X    XXXXXX             XXXXXXXX   X           XXXXXXX
XX  XX XXXXXXXXXXXXXTXXXXXX XXXXXXXXXXX XX    XX XXXXXX XXXXXXXXXXXXXX
XX XXX XXXXXXXXXXXXX XXXXXX XXXXXXX XXX XX XX XX XXXXXX XXXXXXXXXXXXXX
XX   X      XXXXXXXX        XXXXXXX        XX      X    XXXXX       XX
XXXX XXXXXX XXXXXXXXXXXXX XXXXXXXXXXXXX XXXXXXXXXXXXXXX       XXXXX XX
XX T XXXXXX XXXXXX              T    XXXX   XXXXXXXXXXXXXXXXX XXX   XX
XX XXXXXXXX        XXXXXX XXXXXXX XX      X  XXXXXXXXXXXXXXXXXXXX XXXX
XX   XXXXXX XXXXXXXXX     XXXXXXX XXXXXXXXXX     X   XX   XXXX XX XXXX
XXXX XXXXXX XXXXXXXXX XXXXXXXXXXX XXXXXXXXXXXXXX   X    X         XXXX
XXXX        XXXXX     XXXXXXXX    XXXXXXXXXXXXXXXXXXXXXXX XXXXXXXXXXXX
XXXXXXXXXXX XXXXX XX XXXXXXXXX XXXXXXXXXXXXXXXXXXXXXXXXXX      XXXXXXX
XXXXXXXXXXX       XX  XXXXXXXX XXXXXX  X     XXXXXXXXXXXXXXXX XXXXXXXX
XXXXXXXXXXX XXXXXXXXX XXXXXXXX XXXXXX XXXXXXX XXXXXXXXXXXXXXXX XXXXXXX
XXXXXXXXXXX XXXXXXXXX XXXXXXXX        XXXXXXX XXXXXXXXXXXXX    XXXXXXX
XXXXXX      XXXXXX      XXXXXXXXXXXXXXXXXXXXX    XXXXX      XXXXXXXXXX
XXXXXXXX XXXXXXXXXXXXXX         XXXXXXXXXXXXXXX        XXXXXXXXXXXXXXX
XXXXXX   XXXXXXXXXXXXXXXXXXXXXX  X       XXX XXXXXXXXX XXXXXXXXXXXXXXX
XXXXXX XXXXXXXXXXXXXXX       XXX   XXXXX XXX XXXXXXXX  XXXXXXXXXXXXXXX
XXXXXX XXXXXXXXXXX     XXXXX     XXXXXXX     XXXXXXXX XXXXXXXXXXXXXXXX
XXXXXXT            XXXXXXXXXXXXXXXXXXXXXXXXXXXXXXXXXX       X        F
XXXXXXXXXXXXXXXXXXXXXXXXXXXXXXXXXXXXXXXXXXXXXXXXXXXXXXXXXXXXXXXXXXXXXX